
111111
10C001
100001
1P0E01
111111
